X0p0P000p0
10101E1e00
101010001K
00P0p01010
011K0C1010
0000100p00